NO #FF0000
SO #00ff00
WE #0000ff
EA #ff00d0
F 220,100,0
C 225,30,0


    1111111111111111111111111
    1000000000110000000000001
    1011000001110000000000001
    1001000000000000000000001
11111111101100000111000000001
10000000000110000011101111111
11110111111111011100000010001
11110111111111011101010010001
110000001101010111000 00010001
10000000000000001100000010001
10000000000000001101010010001
11000001110101011111011110N01
11110111 1110101 101111010001
11111111 1111111 111111111111